200
20
1 1 1 1	1 1 1 0 0 0 0 0 0 0	0 0 0 0 0 0 0 0 0 0 0 0 0 0 0 0 0 0 0 0	0 0 1 1 1 1 1 1 1 1	1 1 1 1 1 1 1 1 1 1	1 1 1 1 0 0 0 0 0 0	0 0 0 0 0 0 0 0 0 0 0 0 0 0 0 0 0 0 0 0	0 0 0 0 0 0 0 0 0 0	0 0 0 0 0 0 0 0 0 0	3 0 0 0 0 0 0 0 0 0	0 0 0 0 0 0 0 0 0 0	0 0 0 0 0 0 0 0 3 0	0 0 0 4 0 0 0 0 0 0	0 0 0 0 0 0 0 0 0 0	0 0 0 0 0 0 0 0 0 0	0 0 0 0 0 0 0 0 0 0	0 0 0 0 0 0 0 0 0 0	0 0 0 0 0 0 0 0 0 0	0 0 0 0 0 3
2 2 2 2 2 2 2 0 0 0 0 0 0 0	0 0 0 0 5 5 5 5 0 0 0 0 0 0 0 0 0 0 0 0	0 0 2 2 4 4 4 2 2 2	2 2 2 2 2 2 2 2 2 2	2 2 2 2 0 0 0 0 0 0	0 0 0 0 0 0 0 0 0 0 0 0 0 0 0 0 0 0 0 0	0 0 0 0 0 0 0 0 0 0	0 0 0 0 0 0 0 0 0 0	3 0 0 0 0 0 0 0 0 0 0 0 0 0 0 0 0 0 0 0	0 0 0 0 0 0 0 0 0 0	1 0 0 4 0 0 0 0 0 0	0 0 0 0 0 0 0 0 0 0	0 0 0 0 0 0 0 0 0 0	0 0 0 0 0 0 0 0 0 0	3 0 0 0 0 0 0 0 0 0	0 0 0 0 0 0 0 0 0 0	0 0 0 0 0 3
2 2 2 2	2 2 2 0 0 0 0 0 0 0	0 0 0 0 0 0 0 0 0 0 0 0 0 0 5 0 0 0 0 0	0 0 4 4 4 2 4 2 2 4	4 4 4 4 4 4 4 4 4 4	4 4 4 2 0 0 0 0 0 0	0 0 0 0 0 0 0 0 0 0 0 0 0 0 0 0 0 0 0 0	0 0 0 0 0 0 0 0 0 0	0 0 0 0 0 0 0 0 0 0	3 0 0 0 3 0 3 0 3 3	3 0 0 0 0 0 0 0 0 0	0 0 0 0 0 0 3 0 0 0	2 0 4 4 4 0 0 0 0 0	0 0 0 0 0 3 3 0 0 0	0 3 3 0 0 0 0 0 0 0	0 0 0 0 3 0 3 0 0 0	0 0 0 0 0 0 0 0 0 0	0 0 0 0 0 0 0 0 0 0	0 0 0 0 0 3
2 2 2 2	2 2 2 0 0 0 0 0 0 0	5 5 5 0 0 0 0 0 0 0 0 0 0 0 0 0 0 0 0 0	0 0 2 2 2 2 4 2 2 4	2 2 2 2 2 2 2 2 2 2	2 2 4 2 0 0 0 0 0 0	0 0 0 0 0 0 0 0 0 0 0 0 0 0 0 0 0 0 0 0	0 0 0 0 0 0 0 0 0 0	0 0 0 0 0 0 0 0 0 0	3 0 0 0 0 0 0 0 0 3	0 0 0 0 0 0 0 0 0 0	0 0 0 0 0 0 0 0 1 0	2 0 0 4 0 0 0 0 0 0	0 0 0 0 0 0 0 0 0 0	0 0 0 0 0 0 0 0 0 0	0 0 0 0 0 0 0 0 0 3	0 0 0 0 0 0 0 0 0 0	0 0 0 0 0 0 0 0 0 8	0 0 0 0 0 3
2 2 2 2	2 2 2 0 0 0 0 0 0 0	0 0 0 0 0 5 5 5 0 0 0 0 0 0 0 0 0 0 5 0	0 3 2 2 2 2 4 2 2 4	4 2 2 2 2 2 2 2 2 2	2 2 4 2 0 0 0 0 0 0	0 0 0 0 0 0 0 0 0 0 0 0 0 0 0 0 0 0 0 0	0 0 0 0 0 0 0 0 0 0	0 0 0 0 0 0 0 0 0 0	3 3 0 0 0 0 0 0 0 3	0 0 0 0 0 0 0 0 0 0	0 0 0 0 3 0 0 0 2 0	2 0 0 0 0 0 0 0 0 0	0 0 0 0 0 0 0 0 0 0	0 0 0 0 0 0 3 0 0 0	0 0 0 3 0 3 0 3 0 0	0 3 3 0 0 0 0 0 0 0	0 0 0 3 3 3 3 3 3 3	3 3 3 3 3 3
2 2 2 2	2 2 2 0 0 0 0 0 0 0	0 0 0 0 0 0 0 0 0 0 0 0 0 0 0 0 0 0 0 0	0 0 2 4 4 4 4 2 2 2	4 2 4 4 4 4 4 4 4 4	4 4 4 2 0 0 0 0 0 0	0 0 0 0 0 0 0 0 0 0 0 0 0 0 0 0 0 0 0 0	0 0 0 0 0 0 0 0 0 0	0 0 0 0 0 0 0 0 0 0	3 0 0 0 3 0 0 3 0 3	3 0 0 0 0 0 0 0 0 0	0 0 0 0 0 0 1 0 2 0	2 0 0 0 0 0 0 0 0 0	0 0 0 0 0 0 0 3 3 0	0 0 0 0 0 0 0 0 0 0	0 0 0 0 0 0 0 0 0 0	0 0 0 3 3 0 0 0 0 0	0 0 0 3 0 0 0 0 0 0	0 0 0 0 0 3
2 2 2 2	2 2 2 0 0 0 0 0 0 0	5 5 5 5 5 0 0 0 0 0 0 0 0 0 0 0 0 0 0 0	0 0 2 4 2 2 2 2 2 4	4 2 4 4 4 4 4 4 4 4	4 4 4 2 0 0 0 0 0 0	0 0 0 0 0 0 0 0 0 0 0 0 0 0 0 0 0 0 0 0	0 0 0 0 0 0 0 0 0 0	0 0 0 0 0 0 0 0 0 0	3 0 0 0 0 0 0 0 0 3 3 0 0 0 0 0 0 0 0 0 0 0	3 0 0 0 2 0 2 0 2 0	0 0 0 0 0 0 0 0 0 0	0 0 0 0 0 0 0 0 0 0	0 0 0 0 3 0 0 0 0 0	0 0 0 0 3 3 0 0 0 0	0 0 0 0 0 0 0 0 0 0	0 3 0 0 0 0 0 0 0 0	0 0 0 3
2 2 2 2	2 2 2 0 0 0 0 0 0 0	0 0 0 0 0 0 0 0 0 0 0 0 0 0 0 0 0 0 0 0	0 0 2 4 2 2 2 2 2 4	2 2 4 2 2 4 2 2 4 2	2 4 2 2 0 0 0 0 0 0	0 0 0 0 0 0 0 0 0 0 0 0 0 0 0 0 0 0 0 0	0 0 0 0 0 0 0 0 0 0	0 0 0 0 0 0 0 0 0 0	3 0 0 0 0 0 0 0 0 3	0 0 0 0 0 0 0 0 0 0	0 0 0 0 1 0 2 0 2 0	2 0 0 0 0 0 0 0 0 0	0 0 0 0 0 0 0 0 0 0	0 0 0 0 0 0 0 0 0 0	0 0 0 0 0 0 0 0 0 0	0 0 0 0 0 0 0 0 0 0	0 0 0 3 0 0 0 0 0 0	0 0 0 0 0 3
2 2 2 2	2 2 2 0 0 0 3 3 3 0	0 0 0 0 0 0 0 0 0 0 0 0 0 0 0 0 0 0 0 0	0 0 2 4 4 4 4 4 2 4	4 2 4 2 2 4 2 2 4 2	2 4 2 2 0 0 0 0 0 0	0 0 0 0 0 0 0 0 0 0 0 0 0 0 0 0 0 0 0 0	0 0 0 0 0 0 0 0 0 0	0 0 0 0 0 0 0 0 0 0	3 0 3 0 0 0 0 0 3 3	0 0 0 0 0 0 0 0 0 0	3 0 0 0 2 0 2 0 2 0	2 0 0 0 0 0 0 0 0 0	0 0 0 0 0 3 3 0 0 0	0 0 0 0 0 0 0 0 0 0	0 0 0 0 3 0 3 0 0 0	0 0 0 0 0 0 0 0 0 0	0 0 0 3 0 0 0 0 0 0	0 0 0 0 0 3
2 2 2 2	2 2 2 3 0 0 0 0 0 0	0 0 0 0 0 0 0 0 0 0 0 0 0 0 0 0 0 0 0 0	0 0 2 2 2 2 2 4 2 2	4 2 4 2 2 4 2 2 4 2	2 4 2 2 0 0 0 0 0 0	0 0 0 0 0 0 0 0 0 0 0 0 0 0 0 0 0 0 0 0	0 0 0 0 0 0 0 0 0 0	0 0 3 3 0 0 0 0 0 0	3 0 0 0 0 0 0 0 0 3	3 0 0 0 0 0 0 0 3 0	0 0 1 0 2 0 2 0 2 0	2 0 0 0 0 0 0 0 0 0	0 0 0 0 0 0 0 0 0 0	0 0 0 0 0 0 3 0 0 0	0 0 0 0 0 0 0 0 0 0	0 0 0 0 0 3 0 0 0 0	0 0 0 3 0 0 0 0 0 0	0 0 0 0 0 3
2 2 2 2	2 2 2 0 0 0 0 0 0 0 0 0 0 0 0 0 0 0 0 0 0 0 0 0 0 0 0 0 0 0	0 0 2 4 4 4 4 4 2 4	4 2 4 2 2 4 2 2 4 2	2 4 2 2 0 0 4 4 4 0	4 0 4 4 4 0 4 4 4 0 0 0 0 0 0 0 0 0 0 0	0 0 0 0 0 0 0 0 0 0	0 3 0 0 3 0 0 0 0 0	3 0 0 0 0 0 0 0 0 3	0 0 0 0 0 0 0 0 0 0	0 0 2 0 2 0 2 0 2 0	2 0 0 0 0 0 0 0 0 0	0 0 0 0 0 0 0 0 0 0	0 0 0 0 0 0 0 0 0 0	0 0 0 3 0 0 0 0 0 0	0 0 0 0 0 0 0 0 0 0	0 0 0 3 0 0 0 0 0 0	0 0 0 0 0 3
2 2 2 2	2 2 2 0 0 3 3 3 0 0	0 0 0 0 0 0 0 0 0 0 0 0 0 0 0 0 0 0 0 0	0 0 2 4 2 2 2 2 2 4	2 2 4 2 2 4 2 2 4 2	2 4 2 2 0 0 4 0 4 0	4 0 4 0 0 0 4 0 4 0 0 0 0 0 0 0 0 0 0 0	0 0 0 0 0 0 0 0 0 0	0 0 0 0 0 0 0 0 0 0	3 3 0 0 0 0 3 0 0 3	0 0 0 0 0 0 0 0 0 0	1 0 2 0 2 0 2 0 2 0	2 0 0 0 0 0 0 0 0 0	0 0 0 0 0 0 0 3 3 0	0 0 0 0 0 0 0 0 0 0	0 0 0 0 0 0 0 0 0 0	0 0 0 0 0 0 0 0 0 0	0 0 0 3 0 0 0 0 0 0	0 0 0 0 0 3
2 2 2 2	2 2 2 0 0 0 0 0 0 0	0 0 0 0 0 0 0 0 0 0 0 0 0 0 0 0 0 0 0 0	0 0 2 4 2 2 2 2 2 4	4 2 4 2 2 4 2 2 4 4	4 4 4 2 0 0 4 4 0 0	4 0 4 0 0 0 4 0 4 0 0 0 0 0 0 0 0 0 0 0	0 0 0 0 0 5 0 5 0 0	0 0 0 0 0 0 0 0 0 0	3 0 0 0 0 0 0 0 0 3 3 0 0 0 0 0 0 0 1 0 2 0	2 0 2 0 2 0 2 0 2 0	0 0 0 0 0 0 0 0 0 0	0 0 0 0 0 0 0 0 0 0	0 0 0 0 0 0 0 0 0 0	0 0 0 0 0 0 0 0 0 0	0 0 0 0 0 0 0 0 0 0	0 6 0 0 0 0 0 0	0 0 0 0 0 3
2 2 2 2	2 2 2 0 0 0 0 0 0 3	0 0 0 0 0 0 0 0 0 0 0 0 0 0 0 0 0 0 0 0	0 0 2 4 2 2 2 2 2 2	4 2 4 2 2 4 2 2 4 4	4 4 4 4 0 0 4 0 4 0	4 0 4 0 0 0 4 0 4 0 0 0 0 0 0 0 0 0 0 0	0 0 0 0 0 0 0 5 0 0	0 0 0 0 0 0 0 0 3 3	3 0 0 0 0 0 0 0 0 3	0 0 0 0 0 0 0 0 2 0	2 0 2 0 2 0 2 0 2 0	2 0 0 0 0 0 0 0 0 0	0 0 0 0 0 3 3 0 0 0	0 0 0 0 0 0 0 0 0 0	0 0 3 0 0 0 0 0 0 0	0 0 0 0 0 0 0 0 0 0	0 0 0 6 0 0 0 0 0 0	0 0 0 0 0 3
2 2 2 2	2 2 2 0 0 0 3 3 3 0	0 0 0 0 0 0 0 0 0 0 0 0 0 0 0 0 0 0 0 0	0 0 2 4 2 2 2 2 2 4	4 2 4 2 2 4 2 2 4 4	2 4 2 4 0 0 4 0 4 0 4 0 4 4 4 0 4 4 4 0 0 0 0 0 0 9 0 0 0 0	0 0 0 0 0 0 0 5 0 0	0 0 0 0 0 0 0 0 0 0	0 0 0 0 0 0 0 0 3 3	0 0 0 0 0 0 0 0 2 0	2 0 2 0 2 0 2 0 2 0 2 0 0 0 0 0 0 0 0 0	0 0 0 0 0 0 0 0 0 0	0 0 0 0 0 0 0 0 0 0	3 0 0 0 0 0 0 0 0 0	0 0 0 0 0 0 0 0 0 9	0 0 0 6 0 0 0 0 0 0	0 0 0 0 0 3
2 2 2 2 2 2 2 1 1 1 1 1 1 0	0 0 0 0 0 0 0 0 0 0	0 0 0 0 0 0 0 0 0 0	0 0 2 4 4 4 4 2 4 4	2 2 4 2 2 4 2 2 2 2	2 4 2 2 1 5 5 5 1 1	5 1 1 5 1 5 1 5 5 5	1 1 5 5 1 1 1 1 1 0	5 5 0 5 0 1 1 0 1 1	1 0 0 0 0 1 1 1 3 3	3 3 3 0 0 0 0 0 0 3	0 0 0 0 1 1 1 1 2 0	2 0 2 0 2 0 2 0 2 0	2 0 0 1 0 0 0 1 1 1	1 1 1 1 0 0 0 0 0 0 0 0 0 0 0 0 0 0 0 0	0 0 0 0 0 0 0 0 0 0	0 0 0 0 0 0 0 1 1 1	1 1 1 1 1 1 1 1 1 1	1 1 1 1 1 1
2 2 2 2	2 2 2 2 2 2 2 2 2 0	0 0 0 0 0 0 0 0 0 0	0 0 0 0 0 0 0 0 0 0	0 0 2 4 4 4 4 4 4 4	2 2 4 2 2 4 2 2 2 2	2 4 2 2 2 5 2 2 2 5	2 5 2 5 5 5 2 5 2 2	2 5 2 2 2 2 2 2 2 0	0 0 0 0 0 2 2 0 2 2	2 0 0 0 0 2 2 2 2 2	2 2 2 0 0 0 3 0 0 2	0 0 0 0 2 2 2 2 2 0	2 0 2 0 2 0 2 0 2 0	2 0 0 2 0 0 0 2 2 2	2 2 2 2 0 0 0 0	0 0 0 0 0 3	3 3 3 0 0 0	0 0 0 0 0 0 0 0 0 0	0 0 0 0 0 0 0 2 2 2	2 2 2 2 2 2 2 2 2 2	2 2 2 2 2 2
2 2 2 2	2 2 2 2 2 2 2 2 2 0	0 0 0 0 0 0 0 0 0 0	0 0 0 0 0 0 0 0 0 0	0 0 2 4 2 2 2 2 2 2	2 2 4 2 2 4 2 2 2 2	2 4 2 2 2 5 2 2 2 5 2 5 2 5 5 5 2 5 5 2 2 2	5 2 2 2 2 2 2 0 0 0	0 0 0 2 2 0 2 2 2 0	0 0 0 2 2 2 2 2 2 2	2 0 0 0 0 0 0 2 0 0	0 0 2 2 2 2 2 0 2 0	2 0 2 0 2 0 2 0 2 0	0 2 0 0 0 2 2 2 2 2	2 2 0 0 0 0	0 0 0 0 0 0	0 0 0 0 0 0 0 3	0 0 0 0 0 0 0 0 0 0	0 0 0 0 0 2 2 2 2 2	2 2 2 2 2 2 2 2 2 2	2 2 2 2
2 2 2 2	2 2 2 2 2 2 2 2 2 0	0 0 0 0 0 0 0 0 0 0	0 0 0 0 0 0 0 0 0 0	0 0 2 4 2 2 2 2 2 2	2 2 4 2 2 4 2 2 2 2	2 4 2 2 2 5 2 5 2 5	5 5 2 5 2 5 2 5 2 2	2 2 2 5 2 2 2 2 2 0	0 0 0 0 0 2 2 0 2 2	2 0 0 0 0 2 2 2 2 2	2 2 2 0 0 0 0 0 0 2	0 0 0 0 2 2 2 2 2 0	2 0 2 0 2 0 2 0 2 0	2 0 0 2 0 0 0 2 2 2	2 2 2 2 0 0 0 0	0 0 0 0 0 0	0 0 0 0 0 3 0 0 0 0 0 0 0 0 0 0 0 0	0 0 0 0 0 2 2 2 2 2	2 2 2 2 2 2 2 2 2 2	2 2 2 2
2 2 2 2	2 2 2 2 2 2 2 2 2 0	0 0 0 0 0 0 0 0 0 0	0 0 0 0 0 0 0 0 0 0	0 0 2 4 2 2 2 2 2 2	2 2 4 2 2 4 2 2 2 2	2 4 2 2 2 5 5 5 2 5	2 5 2 5 2 5 2 5 5 5	2 5 5 5 2 2 2 2 2 0	0 0 0 0 0 2 2 0 2 2	2 0 0 0 0 2 2 2 2 2	2 2 2 0 0 0 0 0 0 2	0 0 0 0 2 2 2 2 2 0 2 0 2 0 2 0 2 0 2 0	2 0 0 2 0 0 0 2 2 2	2 2 2 2 0 0 0 0	0 0 0 0 0 0	0 0 0 0 0 0	0 0 0 0 0 0 0 0 0 0	0 0 0 0 0 0 0 2 2 2	2 2 2 2 2 2 2 2 2 2	2 2 2 2 2 2


NOTE:
Positions for Boss:
12259,550
12259,468
12259,386

Check Point 1 Respawn point:
4700, 520

Check Point 2 Respawn point:
11239, 520

Start Boss:
greater than 11630


End point(s)
11950,-137
11990,-137